NO ./texture/brick.png
SO ./texture/brick.png
WE ./texture/brick.png
EA ./texture/brick.png

F 255,100,0
C 0,255,0

1111111111111111111111111
1000000000000000000000001
1000000000000000011111111
111111100000000001
1000000000000000011111111
11111000000000000N0000001
    100000000000000000001
    100000000000000000001
1111100000000000000000001
1000000000010000000000001111
1000000000011110000000001
1000000000000010000000001
1000000000000010000000001   
111111111111111111111111111  
