NO ./texture/brick1.png
SO ./texture/brick2.png
WE ./texture/brick3.png
EA ./texture/brick4.png

F 100,100,255
C 10,50,50

1111111111111111111111111
1000000000000000000000001
1000000000000000000000001
1000000000000100000000001
1000000000000000000000001
100000000000N000000000001
1000000000000000000000001
1000000000000000000000001
1000000000000000000000001
1000000000000000000000001
1000000000000000000000001
1111111111111111111111111
