NO ./texture/brick1.png
SO ./texture/brick2.png
WE ./texture/brick3.png
EA ./texture/brick4.png

C 100,100,255
F 10,50,50

11111111111    1111111111
1000000000011110000000001
1000011111111111111100001
10001               11111
10001               
10001               11111
10001               10001
10001               10001
10001               10001
10001               10001
10001               10001
10001               10001
1000011111111111111100001
101100000000S00000000001
11  10000000111000000001
11  11111111   11111111
