NO ./texture/dentwall.png
WE ./texture/dungeon.png
SO ./texture/hexagons.png
EA ./texture/techwall.png

F 0,266,40
C 0,0,60

        1111111111111111111111111
        1000000000110000000000001
        1011000001110000000000001
        1001000000000000000000001
1111111110110E01
11110111111111011100000010001
11110111111111011101010010001
11000000110101011100000000001
10000000000000001100000000001
10000000000000001101010010001
11000001110101011111011110001
11110111 1110101 101111010001
11111111 1111111 111111111111