NO ./texture/brick1.png
SO ./texture/brick1.png
WE ./texture/brick1.png
EA ./texture/brick1.png

F 100,100,255
C 10,50,50

1111111111111111111111111
1000000000000000000000001
1000011111111111111100001
10001               10001
10001               10001
10001               10001
10001               10001
10001               10001
10001               10001
10001               10001
1000011111111111111100001
100000000000N000000000001
1111111111111111111111111
